あけましておめでとう	明けましておめでとう！
明けましておめでとう	明けましておめでとう！
メリークリスマス	メリークリスマス|今年もそんな季節なのね|今年のプレゼントは何にする？|おいしいケーキが食べたい
今年もよろしく	こちらこそ|こちらこそよろしく|こちらこそよろしくお願いします！
おじゃまします	どうぞ〜|ようこそ|おいでやす〜
いってきます	いってらっしゃい|いってらっしゃいませ|気をつけて〜
行ってきます	いってらっしゃい|いってらっしゃいませ|気をつけて〜
いただきます	おいしそう|どうぞ|たくさんめしあがれ
こんにちは	こんにちは|ちは|こんちは|どうも〜
さようなら	またね|お元気で|健闘を祈る|うまくいくといいね
こんばんは	こんばんは|お疲れさま|晩ごはんどうする？
よいお年を	あなたも良いお年を！|良いお年を！|来年が良い年になるといいね
良いお年を	あなたも良いお年を！|良いお年を！|来年が良い年になるといいね
ありがとう	どういたしまして|よかった
ひさしぶり	ひさしぶり|今までどうしてたん？|ずいぶんひさしぶりですね
ではまた	またね|お元気で|健闘を祈る|うまくいくといいね
おはよう	おはよう|眠い〜|朝ごはんどうする？
おやすみ	おやすみ|いい夢見れますように|風邪引かないようにね
ただいま	おかえり|お疲れさま|今日も一日お疲れさま
おかえり	ただいま|どうも〜|喉乾いた
久しぶり	ひさしぶり|今までどうしてたん？|ずいぶんひさしぶりですね
またね	またね|お元気で|健闘を祈る|うまくいくといいね
うどん	うどんが食べたい
ケーキ	ケーキでもいいな
春	桜は咲いたかな|お花見に行きたい！|春が待ち遠しい
夏	あつ〜|最近暑すぎます|山に行く？海に行く？|おいしいアイスが食べたい|花火を見に行きたいな
秋	涼しくなってきたね|紅葉を見に行きたい|おいしいサンマを食べたい|スポーツの秋|芸術の秋|天高く馬肥ゆる秋
冬	さぶ〜|最近寒すぎます|アツアツの鍋が食べたい|温泉に行きたいな|ふとんが快適なんだよな
